     W       W
WWWW W WWWWW W WWWW
     W   W W W    W
 WWWWWWW W W WW W W
       W W W    W W
 WWWWW W W WWWWWW W
 W       W        W
 W WWWWWWWWW WWWWWW
 W W    F  W W W
 W W WWWWW W W W WWW
 W W     W W W W
   WWWWW W W W WWWW
WW W     W   W
   WWWWWWWWWWWWWWWWW