     #       #
#### # ##### # ####
     #   # # #    #
 ####### # # ## # #
       # # #    # #
 ##### # # ###### #
 #       #        #
 # ################
 # #    *  # # #
 # # ##### # # # ###
 # #     # # # #
   ##### # # # ####
## #     #   #
   #################