EEEEEWEEEEEEEWEEEEWD
WWWWEWEWWWWWEWEWWWWD
EEEEEWEEEWEWEWEEEEWD
EWWWWWWWEWEWEWWEWEWD
EEEEEEEWEWEWEEEEWEWD
WWWWWWEWEWEWWWWWWEWD
EWEEEEEEEWEEEEEEEEWD
EWEWWWWWWWWWEWWWWWWD
EWEWEEEEFEEWEWEWEEWD
EWEWEWWWWWEWEWEWEWWD
EWEWEEEEEWEWEWEWEEWD
EEEWWWWWEWEWEWEWWWWD
WWEWEEEEEWEEEWEEEEWD
EEEWWWWWWWWWWWWWWWWD