EEEEEWEEEEEEEWEEEEWW
WWWWEWEWWWWWEWEWWWWD
EEEEEWEEEWEWEWEEEEWD
EWWWWWWWEWEWEWWEWEWD
EEEEEEEWEWEWEEEEWEWD
WWWWWWEWEWEWWWWWWEWD
EWEEEEEEEWEEEEEEEEWD
EWEWWWWWWWEWEWWWWEWD
EWEWEEEEEEEWEWEWEEWD
EWEWEWWWWWEWEWEWEWWD
EWEWEEEEEWEWEWEEEEWD
EEEWWWWWEWEWEWEWWWWD
WWEWFEEEEWEEEWEEEEWD
EEEWWWWWWWWWWWWWWWWW

