EEEEEWEEEEEEEWEEEEWW
WWWWEWEWWWWWEWEWWWWD
EEEEEWEEEWEWEWEEEEWD
EWWWWWWWEWEWEWWEWEWD
EEEEEEEWEWEWEEEEWEWD
WWWWWWEWEWEWWWWWWEWD
EWEEEEEEEWEEEEEEEEWD
EWEWWWWWWWEWEWWWWEWD
EWEWEEEEFEEWEWEWEEWD
EWEWEWWWWWEWEWEWEWWD
EWEWEEEEEWEWEWEEEEWD
EEEWWWWWEWEWEWEWWWWD
WWEWEEEEEWEEEWEEEEWD
EEEWWWWWWWWWWWWWWWWW

