setWalls(
EEEEEWEEEEEEEWEEEEEW
WWWWEWEWWWWWEWEWWWWD
EEEEEWEEEWEWEWEEEEWD
EWWWWWWWEWEWEWWEWEWD
EEEEEEEWEWEWEEEEWEWD
EWWWWWEWEWEWWWWWWEWD
EWEEEEEEEWEEEEEEEEWD
EWEWWWWWWWWWWWWWWEWD
EWEWEEEEEEEWEWEWEEWD
EWEWEWWWWWEWEEEWEWWD
EWEWEEEEEWEWEWEWEEWD
EEEWWWWWEWEWEWEWEWWD
WWWWEEEEEWEEEWEEEEWD
FEEEEWWWWWWWWWWWWWWW
)
