EEEEEWEEEEEEEWWWWWWW
WWWWEWEWWWWWEWEWWWWD
EEEEEWEEEWEWEWEEEEWD
EWWWWWWWEWEWEWWEWEWD
EEEEEEEWEWEWEEEEWEWD
EWWWWWEWEWEWWWWWWEWD
EWEEEEEEEWEEEEEEEEWD
EWEWWWWWWWWWWWWWWWWD
EWEWEEEEFEEWEWEWEEWD
EWEWEWWWWWEWEWEWEWWD
EWEWEEEEEWEWEWEWEEWD
EEEWWWWWEWEWEWEWWWWD
WWEWEEEEEWEEEWEEEEWD
EEEWWWWWWWWWWWWWWWWW