EEEEEWEEEEEEEWEEEEEE
WWWWEWEWWWWWEWEWWWWE
EEEEEWEEEWEWEWEEEEWE
EWWWWWWWEWEWEWWEWEWE
EEEEEEEWEWEWEEEEWEWE
EWWWWWEWEWEWWWWWWEWE
EWEEEEEEEWEEEEEEEEWE
EWEWWWWWWWWWWWWWWWWE
EWEWEEEE*EEWEWEWEEEE
EWEWEWWWWWEWEWEWEWWW
EWEWEEEEEWEWEWEWEEEE
EEEWWWWWEWEWEWEWWWWE
WWEWEEEEEWEEEWEEEEEE
EEEWWWWWWWWWWWWWWWWW